01030101010303000102000200020303000002000201020001030001030002020103020301030201010103030000000303010001030303030301010300030102020003000002000002010103010200020201000103020000020301000202020101030301
02000201030300030102030202030102020202000101030203020103030202030103030003020002000200020201030200010303010200010000010003000101020202030301010101020101020302020102010300020300020001010001000303020202
03030201000103030203010103000100010103030001030300030100020300000003020302030002030000030002030201000203010303030103000000020203030103000000000300030201010000020002020000000302030203000001030202020303
03020302020202010000030102030301010300000100010103030001000102020202010100000302000003020202010102020201010303030203000203030002030102020300030101030201010301010000010201030103010302020103000203030000
00000103020003020101020302000300000102010000010200030301010203000003000300010003020303020002000300000001000200030301010102010100000103020301020002010202000001000100010001010203000001010001010101000203
02030300000201010203030002030301000100030303010100010203030000020100020003000303020202020003020001020302030000010302020102000102020303020000030000020101010302020103020000010302030303010003010300020100
03030000000202030203020200020301010300010002030303010001030100020201010102010003020101000001000003030003020003000203020203020001030001020301010000020100030303020200010200010002030000010301030200020000
00020102010102000102020101000302030300010100020300020302010201030301010202020000000003010001010202010303030300010202030100010202020101010103030102020102010203020102010001030200030100020302010100000002
00000202030302000202000203030202000201030203020101010103000201020202010202030200030302000100030303000301030003000203010001010003020302030102030301020000000100010002000103020000030101030201000301030302
00010002020202030301020301010001020002020002030100020202020100030202030103000102000203000103000100000203020302000103030203000303010303000301000201020001020200020101030103030101000100030001030101020003
02020200010303010002030102020001030201020100030102000100030300020201030101030200000100000000030203020100030201030302000002010300000000010302030100030000000203020300030100000301000200000303000302030301
00010002010301020100000301020101010300030202020102000301030002000202030003000100020203010303000302010103000003020000010003010202020300000202000300030003000201010203020202020201030101000000030302000302
01020303000002020100000003020102030102000301000200010000030202030000010302030002000001030300020201000102030301010002000300020102030201010200000002020200020203030201020003030303030001020100010202030300
01000202010103020201030102020102010102020003020100020101010202030103010202000100030302010100020200030100000102030001020103000300020300000300030301020300010100000002020301020302000301010103000302000203
01030202000101010200010003000202010300020302010201020201020303000103000301020301000002010003020003030302010001000000020001000001010002010301000002010000020003010100030100030100000302020303000200020202
03030202020000020102010101030302000301030203010202000203000303020000000301010103030002000000000200030300010002020102010303000101000301000002030103000100010303010101030100000100030003030301000302000100
02030101020201000103030100010003020302000201030301010201000002010302030001000200030003020203010002020001000201000202000101030102000301020300030101030101020001000102030201000001020201010100010301020100
03020103000301030000020103000301000301010202020301010102030100000000010100020100010103010303020101010203000303020101010202030200020202030302030103020203000100010203030300020300020101000303000301030301
03010002030002000302000100030001030300020102000000000303000300000000010300010202030002000300000003020003030001010303020102020203010103000300000300000102000000020001030100030200020102000300030202010002
00030103020100000200030000010202000201020002010300020202000101010200010301010103020200020300020101020001000302000302000003010003000303030302000302020101030202020103010302000303020201000200010001030103
02030302030100020203010000000201030001030102030202000302000101020102030202010002030101030200030302000302000303030300030200000103000301010103000301020202020201020203030300010302010301000100020300000003
03000200000102010002020000020100010201000200000202020103020301020102020203010100020200000101020200020301010202010200020300000300010200020203030201010302010102020100030203000300010100030203010103030103
02010201020201010101000202030300030000000200020300010003020101010302030301030101020300010000020200030300000103000201010302030303010103000102010103010300020200030001000003020102000303020003000103010100
01000101020101030302030200010300020002000203020102020302000302020100030000030202030002030003010100010101010201020100030102010100000301020003030102000002020101020101020002000102000303030102020102030300
01000202020100030303020003030202020201030302000100020302000301000202020002000203030301020302030200020301010303030103000000010302030203030303010300020103000301000100020303010202010201000102010302000301
02020000010303010200030301010001020102000001000201020000000203000001010202010000030201000000000000010303030103030203020102000003000303020000020301010102030303020302020002010100000302030101000003010101
03020300000300010002030003030201020203000002000103010202010203010101030200010101010302030200020103020200030000000103020000010101010003020100030300000002030301020001020101030100000003030201000102020303
00010100010101020203000303020301030003030302030303020201010001020102010102030201000202010203030000020302020202030101030102000302020300020103030203020300010100010202010103000102030201010103000203010100
02020000020003020301000303020200000302000100020203020303020302000103020103030002000001020300010100010301030300030000000102030203020002010302030100000201020001010203030001030003030202000102000303010202
01000103000002030300030000000001030200030303010303000001000100010002030202030201010302020200020202020103010102000203020300000301020303010200010000020001000300010000010000020001020000010201030102030100
00030103020003000302000302000300010200000102020003010001030202020003000201010000010003010002000000020100000302020203020000010202030002030302010201020002030003000300000000000202020201010201030101000300
00000302020002030301030003010200030101010000030301020102020100020200030001010303010101030000030103030300000201010103030003030200010300000201010101020300000200000202010102030301030102000003010202000003
03020102020103000203000103020203010203000100020203010102010200030300020300000101030101010202030100020001000201000100030002000102000003030002020103010000030102000303010200010000000001020101030302020003
02020203020202000301000003030003010103010102030200000301010101000301020101030202000202000102020103020000010200010201030303020103030203020102020202000300020100030303000000030301010002010102020001000102
03020100000201000101000003020103000102020301010203010102020101030203030000030301000000020003010300000102020002020100020203000001010001000200000100000000020301030203010102010300020000010302020200030303
00020201010202010301010300020000020302020200030200010202000202000002010001030301010103000001030103020300030103000300020002010200030300030000010200000100010001020301030303030203000202000103000302010302
00020200000302010001030002000101030300020200010002010202010101020301010103030300030000030100020203010301020001000302010202010000000101000202030302010201000300020100030100000202010201020200010103010103
02030001010003020101010300020101010200020201020200020303030101030101020100030303000200000001020002010001030001010203030003000100000102020300030300000300020201000100010000020200020201010203010200020301
02010202000100030300030000030103030103010001010103020201010301030001020201030202000102000302010203010300030201010201030103030301030200000101030303010303020103030000020001030201000203030303010303000100
00020302000000030302000100010203020300000100020202000102010103030102000203020000010102000300020200000203030202000101020103020200030103000302000301030100010001020003030203020200010302020001020302010103
03020303020202030002010100030000030003000000010101010001020001010100000200020200030302000201030103000203010103020301030200020003010202020103030300000301020002030300010002000202000101000302020201030303
03030003020201000203010203030201010203010200000303030000020301010201030100020001020202030200010001020100010000020302020200010301030003020102010001020202010001010101000103010002000202010000030202010101
03020202020302020000030103020301020203030302010302030000000000010002000102020301020203000002010003000003020202020100020000030003010103020202000002010003020100010102020103030101030003020101000303000003
03000002010301000001020202030203030000030303030003030301020200030301000300020202000002030301030202010301010303020000000102030001020200020101030300030102030200030202030200030202030001030000000003010302
01020302000002010200030102000102000201020301020201000103030301030202030002030103030301030101010302010301010300000200010300020103010200000203030301030103010302030000010102010002000302010103010101020301
00030003020101030100020202010100010201010100000202010002030102010103000102010300030303000301010303000101030301010202020002000103030000020302030101020001000000020203000000030103020001000102010103000200
01000303030000030200030000000001000101030003020100010201010302030101020101030202000202030202000302020100030203020302010102000001020100000200020203030102020000000300010101030301030103010000030103020200
01000302030003010203030200020203000001020102030000010001030303010100000203010101010000010102030102000201000202000200010101020202020101000102020001010002000200020102030000010002030100030003030300010003
02010001000300010203020003020102030100010303030202020103000200010100020201000002020300030000000002010003020000000300010000020100030303010102010100020100010102000103020303010300000102010101000001030002
01020000030001010000020201030201020102010303010201030002030001000200000200030202010300020003010103020001010103020203010000010301020200000100020103020203030001030302000001030003010003000003010201010001
03010100000200000302000203010301020203010003000201010002030100020303000301020102030003030300020003030202020200030103000203000301020300000202010201000000010300030002030300000100000201020301020001010103
03020302030102000303030000020103030303020102020200020200030102010200020203010303020101010303010202000303010102000001020302030202000202010001020200020003030000000101030100030002030300000203020200020302
02010300020203030100010002000103010001000303030203030003010200000000010103030201020101000200030303030102010202010203030000010001000102000103030002020101000201020301020203020200020300000100030000000100
03010301020103000102000000020203020303030300010301000001000301010300020100000103020203030202000303020203020300000103010201030303030103010102020202020002020103000001030101010002030300020101000303000300
03030302020002010200020203000302010301010001010001020302030303030200020202000201000102000301000103020002030201020002030000000000010103010200010102030101000301030203010301020002030302010101000102010203
02020001030001010100020303030103000300030202000303010303000103000000010000030000030300000200010002000301000200000100020201020003000200030000010101020301030000020000030001020301030303030102010101010301
03000100020001010002000201010301010201030000030303020301030001010300010001000001010301010303030003030102030003010203000200030303000100010101010303010300010201030103000202030103000100000303020201030303
01020201020201010103030300020101020003000003030002000202030202030301030003000302000203010002030301010100000301000103000102010300000003000000000003000001030003020000000002020203010102010302020202020202
01020100010101020202020302010100030303030000030003010302030002010202000002000201020303010202010202030300010300030302020100020203030102020002010100030100010100010300000001030103030003000301010301000203
03030003030201010202030102020302000303010101020101010202010101030101020003010301010103000202010103010003000201010103000101000302030201020303020201000200020203000302020202020102030203030203010000020202
01010303020201030200000203020100030101010002000103010303020103030100030000010101020202020303000300000002010200020001010000020201000102030103010201000101010203020103030200020303010000000203010001030300
00000101010000030003030101010301000200030202010102010001010302010103020001030103020002020001020001000003030100020102000103020001010102000302020203020103020201010302020003000301030203030300030001010101
03020301030102020100030003020102030301020300030001000101020101030002020203020103030203020202030301000100000301030102000200000002010302000203000002000201000103030203010301020002030200000301010201000302
02010303020202000200010100020201030301000202010103020303020201000000030101020102030202030203010201000102000101000202020200000103020103020200000300030301030302020200020100000203020200010100030202020103
00020303010001010101020203010202000203000200020100020103010303030200030003020302020303020303010303000202010302030001000200000103020002020100010003010202020202010101030003030302030002010302010300010200
02020000020302000100020101000303000203000101010303030002030200020102030303010003030101020003010202030303000000030202020303030101020100030102020202030300020201010002030000020202010002010103010201030103
01000002020101000202010203030000000203010301010002030103000100020103000203010102000101000103020003010203030301000302020001010003030000010000030203020302010300020102000003030202010100020102020302020203
03010300030002020002010300010100020001020203020202010303000201010101020003000102000002020202020001000002020203020001010300030300020300020002000003000301000301030200020301010000030203030001030203000303
00030003030301010002020303000202000201020203030102020203020203020002010003020203020101000202010302020103010203000003010301030200010203010002030303000103030203000202030300020303000300010300030302030302
00020100000103020200030103000300030103000001020102020001020201000103020202000203000300010303030101030000020303030002010000030201030302020102000002010000010000000102030002030303020203000301020101000100
00020002000101010303020300010102030303020303000100000001000202000200020101000300020202000203000302030202030102010100030103010203030202020101010301000102010103010003010203020203000201010001020202020003
00000302030301030101030303030101000301030202000201000200000001020003010302010102030102030003000000020003030101000103030300020102020000000002030201010200000000000101020300020203010102020300030201000000
00020102000101010202000103000002000202000203030102030301000100010301030201000300010000010200000101030103020000030200000101030302000000030002020202030003020201010103030103030300000101020001030101000202
00020103000102020103030300020300010000020300030302000002010000020002010101000103030102020002000003000102000202030002020203010303010000000203030301020001020000000000030101010202020001030000030201000301
02030103010301020303020100010003000001010100020301030201030000020300020003030003010003020100020303000102010100000201020203010000000101010200020100020202010101000100030102000303010002010201000000010303
00000300010201020103000300030303030001020003000301000201030102030200030001000201020301000100030002020102020303030001020002020203030303020003020300010001020102030100010101010302010300020300000102000301
01030002030300030002000000020000000202010103030200020303000100000003030201020301000101020301020001020103000201000201010001010102020202010101030203010100030000000201030103020200020202030301010001020302
00010303000303010100000003000301020003010303010103030202010203020203020003030202000100030202000203030102000202030001020000000100030200010100010101000000020000010101010301030102000201020101010201000302
02030200020003000300010200020202000001030200000301010200010302030200030101030103000203000002000001010002010201000102030002020203000103020201000102030201000101020101020000010103030200000202010001000303
01020303020000030301000302000203020201010302010102010002010100000101000202000200010201010101010102030001020300020203020003020000010102000002010300020003000003000300000200030203020203030201010000030203
00000100010300020100020201010200020300020103030200010301010301020001020202000303010202020301030103010302010202030300010301020300000003030101020302020201020002000101030100020003020200000301010202000303
02010201000203030303020102010303020303020001020000010301000201010103020202010000000000010003000103000203020001020102020301030100030102030302000000020303020300020000010303010000010101000002010303000000
01010100020300010300020101030101000200020202000103030102010000000102000102000002000302000001020201000001000203030002000103030000000303030103010203000101020302030000010202010100000303010003030300000101
03010302030103010301010302010202020300010302010002020201010001030001020203010302030302000002030302000300030301000200000101000201010302010102010002010202030101020202020201000003000001000300030103000000
00000302030103000200020003010102000101000203000301030103030301010201010100020300020200030000010201030103000002000101030000030300030000010303010300000002020202000303030202030103020101020102000301030302
01000100020103020201020303010200020102010100010301000300000002010102000203030201020203000303010302030003000301010103000202030100020200020200020002000103020002030201000001000001000302010003010002010003
00030300000303030201010301010301010203010302000201000102010202030100030301030003000300010203010003020100030103030000030200030303030300030100000101000001000100020303020101010200030100000003020100020001
02030303030103000002010102000102010201000103030301010303020203020000000102010102000301020101030203030000020203030301000003020000020301000301020103000101000303020203030100010000030103010202010002020100
02020300000003010100010100010303000300030100030203000001010003030202020302020201010101020102010002010203000102030002030300010200000202000103010300010000030303000103020001020301000000010303020103030203
01020201020300000201030300020200000002000203030203020201030003000202020003010200030301020103010202010301020201030201010103000303000202000303020203010303010200000201010102020103030301030102010303030102
01030103010202020202030103020000000201010200010202020203020303010201000301000200030201010100010303020201020301020102010203000102020302020103010303000200030001000002000300020102010203010301030100030302
01030001010003030102030301030301010202000203010001020000030201020100020302010303010300000300010002030000010003000303030302030300000101010002020101000201010103020003010101010301030001010103020203020201
00000301030201020302030100000002020202030300030102000103010101000202010301030103030102010203010302010001000203010201010303030102020001030101030000010300010301030102000100030100030203010101010200030001
01020302030300010001000302010103030302000002000203030101010200000002010000010102000101030202000203020103000102010002000303000203000303030100020302030101030101010203010300010003030303010102020300010300
00030001030202030301000303030301030003020000000200000102020303030302000303030100030003000000030101010302020002000101010303000103000203020200020201030202030002020102020200020001010100010003030203030103
00020300010201020101010003010100030300010103010302010201020103030002010202010102000000030203000100030002020301030200000302000103020002010303000001030103010303000102030002010001030303000100000001020003
02000101010101010002020103000001020001010201010003030200010102010102030100000003020203000302010200000202010303030103030202000000010301000002020101000203010301020201010202010003010203000003030001010002
00000003020203020202000201010302000202000100010302020301030201000102030303020001000101020102030002030201000102030103020003020301030301010303000303020203030100010003010103010001010102020201030102030100
02020003020102010200010201030103030302020200000200020300010003010302010300010300010303000102010201000302020201020000000201020301010000030003020101000101010300010300000101020100030101010201000001020102
01030303030002000202000001010301000302020101000000010200030103020303010200030003000303010301010100030103020103010100000203000202010003020303020303020000020103010302030103030102000200030000020102030203
