03030100010103010102000000030002010301010102020303030000000100000103030000000101010102000201010203000000010303020300030301020002010301020203010202030103010003000200000003000101020203000002010002010003
02000102030101010101000303030301000301020303000002030101020002000300010100020301010001030101030102020303020103000301020303000202010302030301030200030100020103000100000003020101010101030303020001000001
00010001010101020303030001030101000200020002030100010003010102020101010103030001030100000200030001030303030000000100020100020001010100010000000100010303030202020103030303010100020103000102020000010201
03030000020300020103020103030003000200010100020201000000030003020302030001020003020301020202020201000202000003010303030301030300000301010002010003010000010102000303010203020103000200010303020302010202
01020100010100020302020101000100030303010101010102000001000102030202010300010201030001020302000200000002010200010302030001030003020200000200030100000100020103010203000203020101020202000202020103020301
01000300010300000103030200000103030102030100010103010003030203020300020200000003030202030003010002010300010302000202020202010002020201000001000201030102030101030000010002000200020102010201020303010103
03030003000301000202020300030300030303010003030102030002030103030202010103020001030103030001030101000301010302000003020103000002000102020203030101010003000300020002020001010000010100000001030200000201
02030202010002010303010200020303030301000202010102010201000000000002020202010201020100020000030101030100000302030003030200020103030201020002000303020003000101030003000301020101000101030303020001010000
01010003030000030201030300020000020301010202030300010202020101030101030003030003000002000002030000030202010001030200020103030301000001030200030003010001010002000202030201000201010001010002010100010302
01030001020202030102020200030200020302010001000301020202020103010101000100020300010301010103000001010000000200000102030303010202000102020301000002020101030003000101000301010202030101030301030201000201
02010200010303000001020303020303010102010201020202010102020301030100010001030000030203010103010000030102000002010102030000010303010001030300010200010003030200020001020003000103010101030302020100020201
00030300000101010001000101020203000300030101030103030202020102000103010002000001030001030100010000010300020302010002030001030302010100010201030203030100020003010001020202010102020200020000030201010103
03010300010300020202010102030202010200030103000102020201000101030000010102010302000001000002000101010001000003000003010001020002020102000102010003000202020301000301000303000003030301010202020202020002
03000103010101010302020303000203000302020202020101020001010103030000030300030003030001010301010102010302000202020201010301000003020100020000000303030201010003010103000100020103000202030001010101000103
03010301030303000102020202020201030103020101010303020303000302020000010103020201010000020103030003000300000000000201000202030102010303030103020000030002010102010303030300000301030102000302030300010101
01020203010100030103010102030000010002000203020302030100020303010303020101020002010203020001010000010103020200010101030103010001030103010201010000020202000202000001020201000302010100000200000200010000
00020102030001000300010201010201020102010201010002020300010103030302020200010002010101000002030001020001010301000000020103010200030301000203020103000303010200010101020200020102000201020300020000000102
00020301030201020002010002010202030002030203020101030002000203020003010000030002030200010302010101000100010201000203030000030101030101010000000203030203000001000002030103000101010102010100000200010000
01010302000001010101000101030001010201020201030201010002020102010303030002020001000000000001010003000201020303000001010200000203000103010300030202010201030100030100000100000202020001020303020100010300
01010301020003010100020203000001000202010001020000010302010103030301020101020301020002000101020201020200030301010203010000010202020101020202020300000102000302010003000102020100010202030000010302000300
01010102020201010000030200020102030103000102010003010203030203010002010000030102030103020100010203010100000301000300000003030101000002010203020300030302020102020003010201010002020102000200010301010302
02000003020100020300000200030101030302010002000201020202000301030201010300020200000301010203030300020102020003000103010201000001020000010300010002020002010003010302020003030103000003010300000301020100
00000001020202020000020000030002020000010003010300000202020201010300000302010100020103010102010002000202020201010301010203000203010203030103020003020202020203030201010003010101010301010002020300030200
01010000020003000301030200010002010301000201030101020303030203030301000102000000030203020202020003000102020103010300030101030103020002000100030003020202000102020101030103010103020300000002030102010101
02000302030003030302030302010000010103030000010201000100030102020002030203020203020303010200030203020002000202020002020002010300030302010200030301020201010000000000000000000101030102000103030100010202
01000001020100020002020303000303020000010203010103000102020000000000020203030201020301020302000300030201010302010101000302000201020203020201000100030100020301010203010102020200000300030103030001020302
03010200020302020103030102010100020201010003020003000001000001010203000301010101020200020101020202000301010300030203020101020200020100030203000200010200020300000203020200020202000303000303020002030202
01010300030000030200030200000001020003000103010300020001030101030201020100020000010102010000000303010101030103010201000001010000010000020003010100010203020202000301030103030200000001020102030002010303
03030200010001000202000002010200030301010003000101020302030302020102030001000201010103010200030101000203030302000301030100000001020203030002000202030001000201020302010002000101030302000201020200030002
01030001020200000100030203010100020103000300010301030101020302030000000203020202020103020202020102000102010102000100010001010002010301010002030203030201000000030100020303010202000001020000020103010301
00000300020000010203020300000003000003010200030003020200000302030302000200010103000003030201000101000101010101020303010302030302000101030303000200010000000301000101020101030200010003030201030001000103
00020103020201020202010101000102020300020303020102030003020201000001010201000100030103030302020202030002010200010102000303030300010000000002020202010203030202010200030300030101030202030303020200010002
03010301010300020103000301020000000201000003030203010001010203000301020001000301010303020302030301010102000002010101020102030002020303000100020201020101010302020300010102030300010101010102000203020100
02010103010003020202000000000300030103020300020200020102000302020201000001010201030200000200010202020003030303030301030000030101000003030101030001030103020001010301000101020201020103010103020201010002
02010203030102020100000202000302000203030100020301030100010300000000030102020203020000010201020100000300000300020003000103000101010000030303010303030303030301000001030001020300020100010301010003010303
03010301010102000103010302000101020101030203010301030301030101010101020200010001030000020102030003000202000202010001010101030300020002030103020001030003020000030203020302030202010100000301030102030303
03000000010100010202020002030303020302020002020000020203020101020201000200000103020301030102020102000203000002010301000302030001030002020200000103000003010200000201030303030101000102020201000100000000
00010003020003000301030100020102010202020303020200030001000102000000020101030102010201020102020102030002000202030300010003030101010303010203020103020202000100000103000000010302000102010200000003000001
02020002010301020202000000020301020001000302000002010101020301030300020200030200020202030101020201030000030100010102030302000003030200010201010301010001030001020000000103030003020103030000020000010301
02000201010101010300020103030203010100030301030302030000000003020002000103030302000201000002020300020201010202020303000202010000000200030301030302020300010003020202010300000100010100030202010103020302
02000200010203010303020300010201010103000001010001000202010003000202010101010203010102000300000102030000010202020001030301000300010000030300010001000301010002010101030102030303010101020001010101030202
00010300000301030003020201010301030203000203030102020302000303030200030002010301010000030303000203020000030201030203000001030200020300000103000002020300010202010002000301000102020302000302010100030203
02010303010201020202010100000002020100030303000102000000030001030300020101020002000001020302030001030000000301030300000101010000000301000002000000000102020300030303030200030303020201010301030302010002
03000302020001020301030300030300020303010002010202030201020002030000020101010200020201020003010301010101030002020002020001030201020002020002030302010203010000020301010102030103030103030203020203030002
01000000010203020303030002000202010200000300010302030003020003000002000301010100020200020103010001030102000301020200010203020300030000000103020203010001020100030303000203020102020301010002000301010200
03030301000100020302010300020001000300000001010000010001000000010301020003030100030002030203000101010100010301000001020303020303000202000102030001030203000301010101010101030302020103030300000201030103
01010003000002030302000301000201020101010202010001030000000001020301000100000301030003020001010300030300010303030201000001030102010203020200030003030000030302010002030302000303020001010102000201020303
00030301000002030200010002000303030003010203010001000100010203010103020000020302000001020002010002020102000200010003020103030102030303020202020002000101010103030303020102000000010002020202030300020102
00000001000301020202000301020201010203020300010001000302020002000302030102030200020202020303000103020203020302020003020101000101030302030000000103000300010300010302000202030300010102010001020300030100
00010101030100000302030203030303000202000300030300000201010301030003010200010201010302020101030301030003000302010003020003010001000301030201020302000103030101030303020303000002030102000300020302020202
00000301030300000202010301000300000200020302030100030000020203020202000102010301030000030200010101030000020300020203000000010302020302020003010203000203030100000002020201020001000301010002030303010003
03030003010002020201030000030101010101020200020101010000030101030100010101030300030002030200000001020202020202020203000101000000000303000103020000000202020200020002000301010002020201020203010303000202
03000203030100030301030100030003000301030102000000010202010003030200030303000101000101010202010001000000020203000001010301030003000102030003000300030103020102020202030303000300000101010201000003010002
01030003020103030103000003020200000100030001020000000303010201000102000002010201010001000003000202020200010000030103010001010001000203030201020203030301010200010200010002020103020200030103020102030003
03000003010102020303010303010102030000020102030000020002010200030201000202030001030302010303030301000000020103020003010101000100020203010100020302020003000000030001010203000203000001020200020102000202
02020303010003000003020202010003000200020302010200020003020300030002030001020002010001000203030102000300030203010002000103020100010103000003010001030102010001020103020100010303020003000102020001000100
02010202000203030102020303000103000001000300030002000000020300000002020102030300020203010303000102000103010303030100020301030301010301030001020202010302030003030303000000020101030303000303000103020300
01020303000000010101030000000101020101020102010102010000030300030301010300000201000002020200020102030302030003020200000300020001020002010100010203010203000300000001030300030103030100020303020302010001
02010002030203030101000001000302010203010200010103010202030303000103000000000202020300000202020103010003030200020000000300030201030201030300020302000102010301000302010100010003030100010200020103000002
03000000020300020301010200030101000102020103020302030002030002000000030102030202000003010303000100030302020002000302010101010301030101020101000301020201000201010103000202020202000303000300010001030201
02010200030200030200020000000102010101010303020002010202010003020303000003020302020203010303010002020201030101000203030202010101000101000303020101020101030203030200020201000001000200000002030000030102
02000300020300030201030303010300030300000000000302030001020100010303000203020000010103010103010300000203000302010003020200030201000201000300000002010303000103000001000100010301030103030102000200020003
00020203010000000003000100010200020003000200020003020102000200020302020101010103000302020000020202010301000000020103000102030003010101000303020003020301030202000103030101030300030101020202010200030200
02030101000003000102020300010303010302000103030300030302020302010203000103020301030302010100020201020103010002030003020103010102020303020203020302000302020003030303010202020103020202000002000203020101
01010203020003010103000103030103030202010003020001010003020303010100010000030200010000030303000100030301000300010101020200000301000100030202000103030203010101020302030002020302030300020203000300010102
02000302010103000200020103030001000100020203010203010002030101000003010102000200010200010302020201010102000001030101000103030201010001010302030203030001010102030103020300000202010100000300030001030300
01030100020003000101000301000003000300030302020003020301020203030003030003030102010003020102020302000101010100030302020202000300030201010100000001030000030203020303010202020200010302020102010203000201
01010302000302030003020202030100030202000101030000030302000103020300010301020002020302030200020300020101020103010302020300020100000002010303030102010202000300010200000101020000030003000100010202020000
03010103020302030202030301010203000102020100030103000303020303020100010303030300000102030001020303030100030303030003030203030100030201010100010100030202030000030301000001030002020001010001000103030002
00000101030201010303030003000303010302010303030003000300000202010001000202000203030303020300020301030201010200010203020000010303020303010200020200030202000200000003020000010203030100020302010002010201
02010100030000030002000301030000030302020002000200010003000100000103030103020203020200000202010302020002020100010300030200010302010302020103000101010103000002000000020200010300000302000201000302020002
01030103010000000002030201010101020203000001020003010302010300000200010201010003000303020202020201010202010100020101000300020102030202010200010301030301000000020302020100030000010101000000020102020101
01010302000103020101020100010202010001020003020102010002010100000303030100030303020100020201000103020202000302030202020003020300020203010103000203030103020003010003000001020200020101000102030202030002
03000303020300000000010201000201010300030302000002010100010100020303030200030102030200030001010100010200000300030101000301000303020303020200030103020200020102000100000202020201000302010303020302000302
00010201030303030100010102030000030201000203010002000203010203020000010201000003020202030002010003010102030101000002000302010300020301000101010200020201030200000003030100020000020202000301000200020102
02010201020101020002000002030001010003020101030103010101000101010002020101000103000102000301000003010300010200020302030100010301030003000303000300010103010003030200000003030000020202020003000301030103
01010002000102010200030301010001000202010201030001030000020300020200010200030100030201000303010302030203030002030300030003030103010202000100020103020302030203010102020201030001030100030101030000010101
00020100030000020001020300020201020301000101000301030100000003020001020002000203020202010102010200030002000003030202000300010003030201010102030103030200020200010100030100000100030001000301010102030002
01020303030103030001020001020100000302030303010202030103030202010101000003010002000100000301030101000101010301030302030001020303000200020201000001010303000303020203030301000001000000000102010102000000
02000203030300020302010203020003000103000000030201030200000002010000000002030101000000000000000202010000020101030000030103030200020101000201030200030202030102010302020300030300030101030101010001030102
00010101030301010000030002030201000300030303030202000202030203010303010001030002030003000301020202000001010100030200000100030303030000030200000000030200000100030203020100020003020300010100020003000003
03000000000003000002010200020103030002000002010001000103000200010202020202020000030102030201000001000303020203010001000003030000020001020101020203000001030000010001000002000002000103010203000203020001
01000002030003000200030300020003030101030101030303030103020300030301030103030201000302030102020002030103030102010001010202010000030000010103000203000101010102000101010100030200020300030203020302020101
02000200010201030000010001010003020102000102000003010003010203000103000103010300030102000002000302030003030203020302010300020200020101010301010301010002020201030003020100030100010101010301020302030201
03020301020301020200010203030300010003000103000103000000020001020000000002030300010102010302030102000100030300020301020002010203010101020200000102010202000100000002030103030201000102010002000101000303
03000303010201030202030203030200000303000201030202020300000200000103020300030000020000000000000202000101030202010201010300010201000300000000010101010302010101030302010201010302020302030103020201010103
00000001020000010200010203010102000101020200030000020301030201010201010202000302030201020202010302020203030003010103000000030200020302020101020000010001000201000102010003030100020002020003030000010002
01030101020200020001010003020303010102030003030302010200030102030100030003030301030303010202030002030000030301020201030101030001020201000302010001010003000103030100020000020000020100010302030103020303
01010300030203010101010203010301030102030300030301030102030202000100020303020101000300000202010100030101010101000301030003020203010300010101010102020103010203020203000203020302020101030300000201010003
02020001000201010000000202010300000102030102010301010202020302000001010303000303030103030202010202020202030201000300010103020300010003000103010102020302030001000302030202010201020001020100010003020000
02020101000002000003030202030301010302010000000103010301030001020300020000020100000203030003000002020100030102020202020203030001000200000103020102000100020100020101020201020300010202010002030101030303
01030100000002030100010303000102010302020100000203030301000302020301000003020302030003010201020301010201010101030200020103020001000003000100010100000201030300000300020100010101000303030201000300000300
02030302020003030200020003030100010002010103020203010103000301020102030200010300030202020102000103030100000102010200000200020102030003010001030003010102030202020001020101010103000301030301030100030203
03030302030000010203020101020201020301030302010100000202020200000300030200000002010102020300010201030103000302030101020101010301030102030003030100000301010003010303020203030002030200000000020300000300
01020100030200000102030202000202020003020300030203030203010100030301020003010002000000030100030303020101010103030002000300030002010301030302030001000100020001010202030203030103010001010200000302020201
02030203030001030001010201020000030200020303020001010103000203020103030100000301030002000300010201030101010300000101020000020000010001020103010001010003010302000202030202000101020303000202000303000102
02010301030300010203000101000203030103030302010103010102030300030202030101030000030001020200010302000102010102000203030002030001010303000300010103020100000000010301030002030201020101000100010200010303
00020301000100030103010302010003000303020203010002020101030200020002020202010301000100030003010200000000030303000102030201000303020203000000030201010102030100030102000000010100000301030200010102010000
01030303020003010300000300030301030200030102000203010201010103030000010200010202020202020102000000000202010200000102000002020301020003030102030102010201010101020202000002020100000003010303000103010200
00010001010101000002000100010201010100020203000300010200010303010002020002010302030203030102020203020200020203020003000303000002030303030100030201010000030300010100000001020302020101000003000000000301
