01020100010100020102010202010508010100020501000101020000080100000201010001000700020206000102020102020100000000020002010200000201010202020201010101070202000001010601020100010201010001010201020001000002
02010102010801000002010101020508010102000002020000020000010108000001010001020205020007010002020002010100010002020006020002000000000501010700010002020000000207000005080200020202050102070700020200010202
02020101000001000100000200000201020101020101020802010202010100020108000206000100000002000000020201020005010201070002000100000101020206000102020001020002020000010200000001000102010000000000010201000200
01020102000101020100020201020200000100020100000000010101010201020002010001000200010201010001010100050000000202000202000002010200020100010100070001010200000602000002020202010602010100000102010501000102
02000100020101020200010101020101000002020201000101000201010101000202000206020202000102060202010006010006020000000101020502010000000005020101020101020100020001080101010000020000010102000202050002020102
02000100010101000102000105000102080202010002020100050200010100000201020106020100020000070101000001000102020200000201000807000201020202010201010200080601010200000202020002000001020101000000010200000001
07000001010002020000020200010001010201020100010001010202010202070206010000000001010100010106010700000208020507050201020000010200000002020202000201070002010002010201020501010100020102020206020201020501
07000002000001000000000100010702020200010100020107000000020601080100010001020202010100020101010101010102000007000001020102020008060105020206000200010200080100010108020101000206020002010102020000010202
08020202000702000002020201000101020001010101000800010002010002020600020201010002020000010101000200010201020202020202020802000002010202010601010102000002000702000101020202010002000208000702020201080202
07010202000101010200010001000002020002000001010002010001020001000102010101070102020000010201000102020202000102010000020000070201020201060700010201010202000001000200000107000000020600020101000000000101
02070205020202000001000007060501010106010002070000000100000102020100020001020001010202010201020501000201000202010201020001020201000100010207080200060100000106010101080100020202000000010002000100010101
00000001000000000000020001080202000201010101010500010205050200010202060102020100000102010102000200000007000200010100020108050101010201020500020102020201010002010205000200020602020008020001070207010102
01000000000001010101020802010102000102010202020100000200010800010200000100020100010000000200010102000102020200020000010200000102060202010202020700010100010100010802020200020006060102010101020102010102
05010102010200010101000201050201010000000208000001050002020200010002000102010200020002020001020200010202000000050107000000010101060002000201060101000002000200000002020002050008010202020102020101060100
00010100010001000200010100010801010201010202010101000202010201070102010100020000000102000602020000000201000101020202010101010001000102020006000102050000010002020101050000000201020001010002020201000200
01000201000102010001000000000001070006010102010001000201000101020200020000010201020200050001000200020200010102000100000000010001020102020101020100010600000202010200020002010002000102010001000102000101
02060102010002000200010100020102010000010002020101000102010000020202010101000000010001000205020000010000020102010202000101010200010201010102050001010102020600010206020002070002010000020002010100000201
00010002010000020201020100070802000207000100010102000001020101010201080208020002000201000700010202000001020100020108010208020506010001010002020201020701000100010200010002010202000208000002010201000002
02000100000201000202020000010207020502020008010501000101000200020102020202000201020100020002000208000100000800000001020000020701020702010105020706000200020102010502010002010208000202070007000201000001
07010202020202000100000102000000010001020100000202050102010101010201020002000001000801020201000206000700020002010201000700020006020102010100010102000000000100020200010202010202010201020100020501010002
02000000010101000200080001020801010007010208010002010102000101010006000107000100020201020202050102010801000000010108010201000002020100020202000000000200010000000101070201000007050201010000000100000208
08010001020002010201020800020102000206000202010205050200020101010202010108010201000100020106000102020600020201010202020107010202010202010000010802000001000000020102020205010102060800000002010107010101
00020202010101020501020102010200000000010202020505070101000100000001020201000100010202010702000602010102010100020201020601010200020000060200020002020201010005000602000101010602020000020002020100010100
00000208000101000800010100010000010802010002020106010102000206010705010002000101000101010102020200010002000002020502020101020105060100000000010001010202010202020102000207000201020100020201000600020102
00000102000000000001010100020700010200020006010102020202000102010002010101010102010100020002020000010002010200050700020202020001000000010001020202020002010102000107020202000102010202000000080000010201
01000102010001010100000000010002010208000202000002010106020108000102000206020102010002010500010108000807020100020207020702000100000200000002010208010200000202000100010202020001000101000001020100020101
00000106050001010502020202000100000201010000000201000002010007000001000100000102000100020102000600020200020701010701060800010202020200000008000002000102010000020000020000000000000201010202020101000201
00020002020100020207010502010000080200000200000800020000080000020201020002020801010200010101020200020001020202000101020002020001010001020000000700020100070100010200010200020002000102020700020000000101
01000102020100000002000000020600020701000001010802000208050100020000010800000201020002000202010000010000000500000001010102000002020000000202010002020000020001010206080000010008020000010100070201020000
02010502010202010001080102010101020102010201010200020201020000000002000100000200060102010001020201000600000800010202020002020000000107000100010102020206020101060001020101070100010002000700020000010002
07010107000001010101020202000000010001010202060102020002020102010100000002000100010102020002020008020600020502010600020102000201020002020100000001010000000102000002020101020101020000020002010002020702
00000102010001020102080105000800020602000200000100000001000100050000060208020000060201020100010202010101000600010702020101010102000000000207020000010100000107010602020101010100020202020100050205020502
02000000010200020101020101010000020600010102020002000602010001020002050102020101010001010200000102080001020100080200010202010201070000000002020002020201010700010201020200010200010201010000010000010100
02020100010202000001010200020101010201000001020802020100020202000101000201010201000102020802000002000101060101010001020202010700020002000102020202010102010101020700010705000102020100000200010202020200
01000102000100010102010201050801020202000000020202050101020802080005020101010101020001020201010200070202020701020002010206000100020000020800020002020201000005010000000102060500000201000101020206010105
00020201000102000002000100000100020105020102000200020006060102010201010801000201010102020101020100010201000201010101000000020202000002020100010007010202010201060001000202010200020006010005010802020202
08000100020202000000010205000200020201010100020001020001000600020005020002010201020102080202010200000002010001010000020101010102020100000201020102020702020000080200020202010002000207020102010200000108
00020102000100020501010001020100020002010202000200010002010201010106000001020102000101020600020102070000000000010601000201010100010002020501000000020202000006010000010207000000000102020200020201020208
00020201020206010001010207010800020102020000010000080206010102010802020005020201020001010200010800080201060200020500000002010200000201020501020102020102020102000200020202010000010200020102010202010001
01010101000001000502000102010007010008010200000207010001010002080501000100000100020100020201000200010207020000020207000100010201020100000007000500060100020202010000000100020206020007010201010001020100
02070002000200020201010000000202000001010202000202020100000102000201000102020100000201080200010101070101000201010001020102010608000201000002020000010002070202010001020200000008020201010100000102000701
01010001000001020100010200020100000002020001000800010108000000080002020100000200000200000201000602010202010101000106020200000007000006020002000801010208000000020201000005020001020200020200010101020107
01000202020100070102020002000000000002020101020100020100010102020801020600000007060202080000010700010002000102010102000202000201010002010002000102010002080201000202020101010101020005000102020100000100
00000101010201010001000100000100020002000200000701020200010200010101000200000001080102020000010202010200020601020201010000020102020100000202000101020200010100010200010000020200010100010102010002010202
01010102000001000102000505020001050001020002020000020000000202060202000101010102020102010102010002010201020205020100010101010202010200010000000002000201050102010101010201010001000001010607070002020002
02000201020000020001000000000002010205020000020600020101000001000100010202020200020001020100050101000200000202000001010202000001000001010005020000010600010002010202010001000007000101000100010102020002
05010102010002000600010202010102010102010102020101000201010200000500000101020501020801020200000102020105000002020102020207000001010000000101020000020002010101020000000200000100000200000001000102000102
05000201010202020102010002020000010102010001020202000002000201010102010101010207000001060100020501000006000100010200020502010001020200000500010505020202000101020601020201010600000200020200010601000002
05010102020001010201020102010206020002020701020102060602010202010000010000010201020000020202010102010006000002010001000200000001010002050200010108010000020107010202010602020001000106020102000101020101
01020001000001010201020006020002020201010501020002060000000001020100080207000201010200010008020101010000020001020800020202060101020205010002020101000002010201020000000202010102000801010105020200020207
02020200010102060001020001010006020008010602020200010002000002020000020201020201010200010002020100010200000200000100010102020101020201020001010200010101050002020100010102010201000100010201000002010500
01010101000002080105010001000000000000060105010201020101020000020101020108000200000101010101020002000002000101020206000000050200010202000202020100000002050008000601020101010001020100060007020102020200
00000002000100010001010801000201060101010006000001000102050100020800000702020000010101020000060201000202000000000100020001070202020200000200020801000001020200020202000007010101020000010201000200000002
01000201050101020200000002010200080200010005010101050102000100060500020200020001010001010100010206010108010100010800000702000202020605000102020701020200010101000102020801010200020201010000010201020001
01000201020000010108010100000100000701000100010002020001020106010007020202020106000201010201020102000101020000060200010002020102000100000001010201000002020001020102010201000100020101020208010200010102
08000200010005020201000000010101000101050200000001020101000001000207020101020100060002010100010200000102020005010001010602010001010202010801020201010001010102020201010200020205000202010001080102020702
02010102020002020002020008020102000001010200000201020100020202000002010002020002080002010102020101000200070802000101000102010201020007020000000202000700010100020000000200010101020100020100020202010000
06010105020102000202000101060202000500080200020600000002010102020201000201060202000000000200020200020201000201010201060201000102020108000102000208000102020100020201000202000201010601000001010207000102
00050101010802010000000202020100020000010202000002010701010201010102020001000101020200050700010101020102020101020102020101020102060100000102000102000201020001020001010008050002020001010200020001000200
00020002060205010001080807020101000002000101070105010801020001000100000002020001000200000102000102000102000000010100050202000001000201010202000202000001080100020201070001010802000001000005050100000101
00010201010602010001000000060608010100020200020201010001010202020001000202070100000202000106000801020002010200020102020100000200000201010102020101000007000201000002010100020107010200010102000202020100
02020701000700060001010100000001000200020501000200020101050005000100000101000600020102000002020000020102000000060801020001000201010600020001020000020701000001070202070100000200050002010101020100010002
08020102000101000101010001020102010201020101020000010202010200000202010000020100010102020202000008020101020002010002000100010002010102010108010102050002000801000201010201020000010200020202000000020201
01020000010701060201020200000007010002010001010105000000080000000101020201020100080107000102000001010201000002080001000701010202000001000001020100010200070100010102010001060002010200000701020002010206
02010601010000020102020200050702020101020105020101070202000100000501020105010100010201000501060102000002000201000202000701020100010200000100000201010001060500020206020101020106020001000100070202010000
00010100000202010002000801010200020001020202020101000702010000060100020701010100050002000001020000000100010201000100020102050102020100000201010502080001000102020100080108010607020201060102010101000200
02010000010205000701000201000101050001080201000001020101010207000001010002010702010002080001020201020200010002010100000107000100010002010602020201010002000500020000010200060002000201010802010802020000
07000800000102010801020207020201060105070101000002020002000802050107000502020100080101000502020005010000010002070201010002080002020101010505000001010207020000010006000101000002020002020102020100010200
01060105010106000200020100010202000808050100020100070001020002020002020000020200000102020202020100010200000101020101000202000201020201020002020200020100000201020802000102070108000002000000020201050205
00010101010200060101050201010501000202000000010101010206000101070100020000000102020102010201010201020101000202010002000700010101080202060702000000000000050100010100050100020101010000020200010002020201
00070102070101020101050202020200010102000200010105020200020002000102000101010202010106010201010202000108000200000200050600010202010502010201000200010007010001010000010105010200020201020100020002000108
07020600020202020200020201010005020001010000000101020000010100010200000000010201000001010206010101000001020207020100000201080802020700010002000001000001020000020000000202000202020001000202000001020100
02010002010101000200020200060102000001010200000102010108010202020202020200000200000500000101010106000501020001000202070101010101000200000002000100020800010001000001020802010100000201000001010102010000
02050101000202020201020000010000060001000100020000010001000200020200020006010100010100010101000202080001000101050200020002010601020001010002010101020001070102020202010101000100070100020001020102010101
00010202080202020001020802020201020200020205070202010201020201000002000102010102000102010001000201050107000000010002020002000000010002000101010200000100000001000202000000000100010101000101020100000101
05020102070502000202070202020100010008000105020700020200010201020005000102020000000001020000010600020001010005050000020101020100000001020001000201050202020200020205000208010100000206000201020000010701
01010000000207000801010202010002000201020000020102080001000202000101020201000100020101010002000800060002010200010202010200020206010500010201000001080702000202010202020206000001020100000100020100000206
02010201020100020201010202020801010201050000000202010000020001000701000000010000000201010202020002020802010000020201020201020102020105010101020000000201000105000102000100010202000101000100010000000002
02000200050101070102010001020101000602020000000201020001020000020101010102020002080001020700000100000101020200020101070200000201060002020102020200020100020101000005010000010102020201000002020001020102
00020001010002070001020001020200010800000102020201000002000702020001010101020202000201010000010000010200020200020000000001000002000102010100000502020100010101020002020102020102050108020000020202010201
00010201020000020000010201050002000001010208010001020100000002000600000000000102060101000200000800020001020101000102000100010102010206050202020101000100010102000201020200010001010202000702020100050001
00020100020202000102020001000102000000010101000001010001000001020000020200010101020202000001000102000000000202080101010102000801020205000101020607080102000202020100020001010100010800020100000000020200
01000201010102020002010202020200000201020801000102010201010000070100010201000102020002020000000206010101020202010702020001000106010201010202010101050001020002070102020102060002020602020002010102010201
02010200000002020101010100000102000200000000020201000200010006010102000201020202020002020102000102010001020002010201000101000102020200000100020001020108000500010102000000020107020101020508050102010100
02020001020201010202000002020002010000010502000202080107000102000502020101020001000101020002020002000101020001010800010001020201000201020102000102010102020101060100080102020201020102020208010102000001
08020202000101070207010208000201020002000202000002080200000000010100020201010202000100020100020100000108020008020201010002010100010101010607000202020102020101000507010200000102010101020202010102010200
06010100000000020002050102020001000001010001000201080201010200000201070201000001010002000102000000000801010007020705010102020102080802020105010001010001020100000102020100060208070002020201020001020101
01020001010107000100010201020101000201020801020201020000010102020202000100050802010001000101010601080001080100000502060100000102010200020201010000020102000002000200000200020005020001000100010006050202
02020202010101010101010100080202000202010007000202020100020101080101000201010205020002010206020002020200010001000602000100010002000200000200000101010102020102010202020100000202010100010000000000010100
00080100010001000100010502000802000600000202020000020207010101000102000101000700000801020002020102000202000002000106080200010100020100000202000101050200020007070102020002020205060002010801020101010000
00010101020000000206000200000001010100020000020200000202020100010100020001000200080601010001020201020200000002020000000102010000000008060002020101010101020100020001000101020102020002020700020202070002
00010202010201070000020201010201000206060201010101010202000200010100000002000201020102000102020008020000020202000000010001010100010101000001080600020102000200020102020201080202000200010101020202000105
01000201010101070200000106020001000001020101000001010001000102020101010101020100000101020206010800010600010201000202070002070102010002020501010000020501010100000102000200000001010000020000020100000102
02060108020001020001010100050602020008010200000102050101000100070601000102000202020202010200000705010001050201000006020001000001020002020106010002000201010105010101080201010202010200010002020202070101
01010202070005000108010201000202010201010100010002000100020002000008000200020101060002010000020100020001000000020002070000000102010001010202000001010000020102020100010000000201020101020100020105010101
00000201010102000002010000000001020101010205020200010201080000010200010601020102050008000502020100010701000002020100020201000101010002020002020501050601010100020100010501000102010007010202010102000102
02010202000001000201010206000101020002000000010202020002050500060005020102020001010102000701000202010100010008000802000700000202050008010002020100020102010002010000060202020802010502020202060100020100
00010000000100000506050200010200020201060100020102010101070102020007000100000200010501010001020108020102050202000100010202070102020001010202000002020002060000000101010101010102000206000802000002000501
00010002000201000202010100000200000202010001020000000102010502020000000802020201010201010000020101020202020100010201000702010002000000020000000201000002010601010101010200000000020105010100020200020600
00020201000202010000020002010100010000010001010102000600000200010101000000020101010101000000020602010000000002010707020001020002070200020702020200010101010000000002020102000101020102000000020200010001
